{
	"tileSet": {
		"tileSetSource": "App/Assets/Sprites/Maps/Tiles.png"
	},
	"tileRenderSize": 32,
	"textureTileSize": 16,
	"layout": [
		["0","0","0","0","0","0","0","0","0","0","0","0","0","0","0","0","0","0","0","0","0","0","0","0","0","0","0","0","0","0","0","0","0","0","0","0","0","0","0","0","0","0","0","0","0","0","0","0","0","0","0","0","0","0","0","0","0","0","0","0","0","0","0","0","0","0","0","0","0","0","0","0","0","0","0"],
		["0","S","S","S","S","S","S","S","S","S","S","S","S","S","S","S","S","S","S","S","S","S","S","S","S","S","S","S","S","S","S","S","S","S","S","S","S","S","S","S","S","S","S","S","S","S","S","S","S","S","S","S","S","S","S","S","S","S","S","S","S","S","S","S","S","S","S","S","S","S","S","S","S","S","0"],
		["0","S","S","S","S","S","S","S","S","S","S","S","S","S","S","S","S","S","S","S","S","S","S","S","S","S","S","S","S","S","S","S","S","S","S","S","S","S","S","S","S","S","S","S","S","S","S","S","S","S","S","S","S","S","S","S","S","S","S","S","S","S","S","S","S","S","S","S","S","S","S","S","S","S","0"],
		["0","S","S","S","S","S","S","S","S","S","S","S","S","S","S","S","S","S","S","S","S","S","S","S","S","S","S","S","S","S","S","S","S","S","S","S","S","S","S","S","S","S","S","S","S","S","S","S","S","S","S","S","S","S","S","S","S","S","S","S","S","S","S","S","S","S","S","S","S","S","S","S","S","S","0"],
		["0","S","S","S","S","S","S","S","S","S","S","S","S","S","S","S","S","S","S","S","S","S","S","S","S","S","S","S","S","S","S","S","S","S","S","S","S","S","S","S","S","S","S","S","S","S","S","S","S","S","S","S","S","S","S","S","S","S","S","S","S","S","S","S","S","S","S","S","S","S","S","S","S","S","0"],
		["0","S","S","S","S","S","S","S","S","S","S","S","S","S","S","S","S","S","S","S","S","S","S","S","S","S","S","S","S","S","S","S","S","S","S","S","S","S","S","S","S","S","S","S","S","S","S","S","S","S","S","S","S","S","S","S","S","S","S","S","S","S","S","S","S","S","S","S","S","S","S","S","S","S","0"],
		["0","S","S","S","S","S","S","S","S","S","S","S","S","S","S","S","S","S","S","S","S","S","S","S","S","S","S","S","S","S","S","S","S","S","S","S","S","S","S","S","S","S","S","S","S","S","S","S","S","S","S","S","S","S","S","S","S","S","S","S","S","S","S","S","S","S","S","S","S","S","S","S","S","S","0"],
		["0","S","S","S","S","S","S","S","S","S","S","S","S","S","S","S","S","S","S","S","S","S","S","S","S","S","S","S","S","S","S","S","S","S","S","S","S","S","S","S","S","S","S","S","S","S","S","S","S","S","S","S","S","S","S","S","S","S","S","S","S","S","S","S","S","S","S","S","S","S","S","S","S","S","0"],
		["0","S","S","S","S","S","S","S","S","S","S","S","S","S","S","S","S","S","S","S","S","S","S","S","S","S","S","S","S","S","S","S","S","S","S","S","S","S","S","S","S","S","S","S","S","S","S","S","S","S","S","S","S","S","S","S","S","S","S","S","S","S","S","S","S","S","S","S","S","S","S","S","S","S","0"],
		["0","S","S","S","S","S","S","S","S","S","S","S","S","S","S","S","S","S","S","S","S","S","S","S","S","S","S","S","S","S","S","S","S","S","S","S","S","S","S","S","S","S","S","S","S","S","S","S","S","S","S","S","S","S","S","S","S","S","S","S","S","S","S","S","S","S","S","S","S","S","S","S","S","S","0"],
		["0","S","S","S","S","S","S","S","S","S","S","S","S","S","S","S","S","S","S","S","S","S","S","S","S","S","S","S","S","S","S","S","S","S","S","S","S","S","S","S","S","S","S","S","S","S","S","S","S","S","S","S","S","S","S","S","S","S","S","S","S","S","S","S","S","S","S","S","S","S","S","S","S","S","0"],
		["0","S","S","S","S","S","S","S","S","S","S","S","S","S","S","S","S","S","S","S","S","S","S","S","S","S","S","S","S","S","S","S","S","S","S","S","S","S","S","S","S","S","S","S","S","S","S","S","S","S","S","S","S","S","S","S","S","S","S","S","S","S","S","S","S","S","S","S","S","S","S","S","S","S","0"],
		["0","S","S","S","S","S","S","S","S","S","S","S","S","S","S","S","S","S","S","S","S","S","S","S","S","S","S","S","S","S","S","S","S","S","S","S","S","S","S","S","S","S","S","S","S","S","S","S","S","S","S","S","S","S","S","S","S","S","S","S","S","S","S","S","S","S","S","S","S","S","S","S","S","S","0"],
		["0","S","S","S","S","S","S","S","S","S","S","S","S","S","S","S","S","S","S","S","S","S","S","S","S","Q","F","F","F","D","S","S","S","S","S","S","S","S","S","S","S","S","S","S","S","S","S","S","S","S","S","S","S","S","S","S","S","S","S","S","S","S","S","S","S","S","S","S","S","S","S","S","S","S","0"],
		["0","S","S","S","S","S","S","S","S","S","S","S","S","S","S","S","S","S","S","S","S","S","S","S","S","Z","X","X","X","C","S","S","S","S","S","S","S","S","S","S","S","S","S","S","S","S","S","S","S","S","S","S","S","S","S","S","S","S","S","S","S","S","S","S","S","S","S","S","S","S","S","S","S","S","0"],
		["0","S","S","S","S","S","S","S","S","S","S","S","S","S","S","S","S","S","S","S","S","S","S","S","S","S","S","S","S","S","S","S","S","S","S","S","S","S","S","S","S","S","S","S","S","S","S","S","S","S","S","S","S","S","S","S","S","S","S","S","S","S","S","S","S","S","S","S","S","S","S","S","S","S","0"],
		["0","S","S","S","S","S","S","S","S","S","S","S","S","S","S","S","S","S","S","S","S","S","S","S","S","S","S","S","S","S","S","S","S","S","S","S","S","S","S","S","S","Q","F","F","F","D","S","S","S","S","S","S","S","S","S","S","S","S","S","S","S","S","S","S","S","S","S","S","Q","F","D","S","S","S","0"],
		["0","S","S","S","S","S","S","S","S","S","S","S","S","S","S","S","S","S","S","S","S","S","S","S","S","S","S","S","S","S","S","S","S","S","S","S","S","S","S","S","S","Z","X","X","X","C","S","S","S","S","S","S","S","S","S","S","S","S","S","S","S","S","S","S","S","S","S","S","Z","X","C","S","S","S","0"],
		["0","S","S","Q","F","F","F","D","S","S","S","S","S","S","S","S","S","S","S","S","S","S","S","S","S","S","S","S","S","S","S","S","S","S","S","S","S","S","S","S","S","S","S","S","S","S","S","S","S","S","S","S","S","S","Q","F","D","S","S","S","S","S","S","S","S","S","S","S","S","S","S","S","S","S","0"],
		["0","S","S","Z","X","X","X","C","S","S","S","S","S","S","S","S","S","S","S","S","S","S","S","S","S","S","S","S","S","S","S","S","S","S","S","S","S","S","S","S","S","S","S","S","S","S","S","S","S","S","S","S","S","S","Z","X","C","S","S","S","S","S","S","S","S","S","S","S","S","S","S","S","S","S","0"],
		["0","S","S","S","S","S","S","S","S","S","S","S","S","S","S","S","S","S","S","S","S","S","S","S","S","Q","F","D","S","S","S","S","S","S","S","S","S","S","S","S","S","S","S","S","S","S","S","S","S","S","S","S","S","S","S","S","S","S","S","S","S","S","S","S","S","S","S","S","S","S","S","S","S","S","0"],
		["0","S","S","S","S","S","S","S","S","S","S","S","S","S","S","S","S","S","S","S","S","S","S","S","S","Z","X","C","S","S","S","S","S","S","S","S","S","Q","F","D","S","S","S","S","S","S","S","S","S","S","S","S","S","S","S","S","S","S","S","S","S","S","S","S","S","S","S","S","S","S","S","S","S","S","0"],
		["0","S","S","S","S","S","S","S","S","S","S","S","S","S","S","S","S","S","S","S","S","S","S","S","S","S","S","S","S","S","S","S","S","S","S","S","S","Z","X","C","S","S","S","S","S","S","S","S","S","S","S","S","S","S","S","S","S","S","S","S","S","S","S","S","S","S","S","?","S","S","S","S","S","S","0"],
		["0","S","S","S","S","S","S","S","S","S","S","S","S","S","S","S","S","Q","D","S","S","S","S","S","S","S","S","S","S","S","S","S","S","S","S","S","S","S","S","S","S","S","S","S","S","S","S","S","S","S","S","S","S","S","S","S","S","S","S","S","S","S","S","S","S","S",".","R","S","S","S","S","S","S","0"],
		["0","S","S","S","S","S","S","S","S","S","S","S","S","S","S","S","S","Z","C","S","S","S","S","S","S","S","S","S","S","S","S","S","S","S","S","S","S","S","S","S","S","S","S","S","S","S","S","S","S","S","S","S","S","S","S","S","S","S","S","S","S","S","S","S","S","S","S","P","S","S","S","S","S","S","0"],
		["0","S","S","S","S","S","S","S","S","S","S","S","S","S","S","S","S","S","S","S","S","S","S","S","S","S","S","S","S","S","S","S","S","S","S","S","S","S","S","S","S","S","S","S","S","S","S","S","S","S","S","S","S","S","S","S","S","S","S","S","S","S","S","S","S","S","S","P","S","S","S","S","S","S","0"],
		["0","S","S","S","S","S","S","S","S","S","S","S","S","S","S","S","S","S","S","S","S","S","S","S","S","S","S","S","S","S","S","S","S","S","S","S","S","S","S","S","S","S","S","S","S","S","S","S","S","S","S","S","S","S","S","S","S","S","S","S","S","S","S","S","S","S","S","P","S","S","S","S","S","S","0"],
		["0","S","S","S","S","S","S","S","S","S","S","S","S","S","S","S","S","S","S","S","S","S","S","S","S","S","S","S","S","S","S","S","S","S","S","S","S","S","S","S","S","S","S","S","S","S","S","S","S","S","S","S","S","S","S","S","S","S","S","S","S","S","S","S","S","S","S","P","S","S","S","S","S","S","0"],
		["0","S","S","S","S","S","S","S","S","M","M","M","M","S","S","S","S","S","S","S","S","S","S","S","S","S","S","S","S","S","S","S","S","I","O","S","S","S","S","S","S","S","S","S","M","M","M","M","S","S","S","S","S","L","L","S","S","S","L","L","S","S","S","S","S","S","S","P","S","S","S","S","S","S","0"],
		["0","S","S","S","S","S","S","S","S","S","S","S","S","S","S","S","S","S","S","S","S","S","S","S","S","S","S","I","O","S","S","S","S","K","A","S","S","S","S","S","S","S","S","S","S","S","S","S","S","S","S","S","L","L","L","S","S","S","L","L","L","S","S","S","S","S","S","P","S","1","1","1","1","1","0"],
		["0","S","Y","S","S","I","O","S","S","S","S","S","S","S","S","I","O","S","S","Y","S","I","O","S","S","S","S","K","A","S","Y","S","S","K","A","S","S","S","S","S","S","S","S","S","S","S","S","S","S","S","S","L","L","L","L","S","S","S","L","L","L","L","S","S","S","S","S","P","S","3","3","5","3","3","0"],
		["0","G","H","J","S","K","A","S","S","V","B","N","S","S","S","K","A","S","G","H","J","K","A","S","V","B","N","K","A","G","H","J","S","K","A","S","S","S","S","S","S","S","S","V","B","N","S","S","S","S","L","L","L","L","L","S","S","S","L","L","L","L","L","V","B","N","L","L","L","3","3","2","3","3","0"],
		["T","T","T","T","T","T","T","T","T","T","T","T","T","T","T","T","T","T","T","T","T","T","T","T","T","T","T","T","T","T","T","T","T","T","T","T","S","S","S","S","S","T","T","T","T","T","T","T","T","T","T","T","T","T","T","S","S","S","T","T","T","T","T","T","T","T","T","T","T","T","T","T","T","T","T"],
		["T","T","T","T","T","T","T","T","T","T","T","T","T","T","T","T","T","T","T","T","T","T","T","T","T","T","T","T","T","T","T","T","T","T","T","T","S","S","S","S","S","T","T","T","T","T","T","T","T","T","T","T","T","T","T","S","S","S","T","T","T","T","T","T","T","T","T","T","T","T","T","T","T","T","T"],
		["T","T","T","T","T","T","T","T","T","T","T","T","T","T","T","T","T","T","T","T","T","T","T","T","T","T","T","T","T","T","T","T","T","T","T","T","S","S","S","S","S","T","T","T","T","T","T","T","T","T","T","T","T","T","T","S","S","S","T","T","T","T","T","T","T","T","T","T","T","T","T","T","T","T","T"],
		["T","T","T","T","T","T","T","T","T","T","T","T","T","T","T","T","T","T","T","T","T","T","T","T","T","T","T","T","T","T","T","T","T","T","T","T","S","S","S","S","S","T","T","T","T","T","T","T","T","T","T","T","T","T","T","S","S","S","T","T","T","T","T","T","T","T","T","T","T","T","T","T","T","T","T"],
		["T","T","T","T","T","T","T","T","T","T","T","T","T","T","T","T","T","T","T","T","T","T","T","T","T","T","T","T","T","T","T","T","T","T","T","T","S","S","S","S","S","T","T","T","T","T","T","T","T","T","T","T","T","T","T","S","S","S","T","T","T","T","T","T","T","T","T","T","T","T","T","T","T","T","T"],
		["T","T","T","T","T","T","T","T","T","T","T","T","T","T","T","T","T","T","T","T","T","T","T","T","T","T","T","T","T","T","T","T","T","T","T","T","S","S","S","S","S","T","T","T","T","T","T","T","T","T","T","T","T","T","T","S","S","S","T","T","T","T","T","T","T","T","T","T","T","T","T","T","T","T","T"]
	],
	"collidableTiles": ["T","I","O","K","A","M","0","L"],
	"tileDrawCoordinates": {
		".": { "x": 2, "y": 3 },
		"?": { "x": 3, "y": 2 },
		"0": { "x": 12, "y": 6 },
		"1": { "x": 0, "y": 4 },
		"2": { "x": 1, "y": 6 },
		"3": { "x": 2, "y": 4 },
		"4": { "x": 0, "y": 5 },
		"5": { "x": 1, "y": 5 },
		"S": { "x": 12, "y": 6 },
		"T": { "x": 0, "y": 0 },
		"G": { "x": 0, "y": 1 },
		"H": { "x": 1, "y": 1 },
		"Y": { "x": 1, "y": 0 },
		"V": { "x": 2, "y": 0 },
		"B": { "x": 3, "y": 0 },
		"N": { "x": 4, "y": 0 },
		"M": { "x": 5, "y": 0 },
		"J": { "x": 2, "y": 1 },
		"I": { "x": 0, "y": 2 },
		"O": { "x": 1, "y": 2 },
		"L": { "x": 2, "y": 2 },
		"K": { "x": 0, "y": 3 },
		"R": { "x": 3, "y": 3 },
		"A": { "x": 1, "y": 3 },
		"Q": { "x": 0, "y": 7 },
		"F": { "x": 1, "y": 7 },
		"D": { "x": 2, "y": 7 },
		"Z": { "x": 0, "y": 8 },
		"X": { "x": 1, "y": 8 },
		"C": { "x": 2, "y": 8 },
		"P": { "x": 3, "y": 4 },
		"W": { "x": 11, "y": 2 }
	},
	"entityPositions": {
		"player": { "x": 1, "y": 28 },
		"groundEnemies": [
			{ "x": 29, "y": 31 },
			{ "x": 8, "y": 31 },
			{ "x": 20, "y": 31 },
			{ "x": 25, "y": 31 }
		],
		"flyEnemies": [
			{ "x": 11, "y": 25 },
			{ "x": 40, "y": 25 }
		],
		"coins": [
			{ "x": 9, "y": 27 },
			{ "x": 10, "y": 27 },
			{ "x": 11, "y": 27 },
			{ "x": 12, "y": 27 },
			{ "x": 18, "y": 24 },
			{ "x": 24, "y": 23 },
			{ "x": 30, "y": 21 },
			{ "x": 44, "y": 27 },
			{ "x": 45, "y": 27 },
			{ "x": 46, "y": 27 },
			{ "x": 47, "y": 27 }
		],
		"key": { "x": 67, "y": 29 }
	}
}